###############
#      @      #
#    b   b    #
# #         ###
#o#  # b   h#a#
#o#h   b    #*#
#a#    b   h#a#
#*#h   b    #o#
#a#    b   h#o#
###h   b    # #
#    ###      #
#           b #
#######o#######
#1     x     *#
###############
